....^^^^^^
.~~~^.e..^
C~~~^....^
.~~~^...e^
A.B.......
